
  R 	800	 600

  NO	   ./xpm/brick1.xpm   
  SO	   ./xpm/brick2.xpm   
  WE	   ./xpm/brick3.xpm   
  EA	   ./xpm/brick4.xpm 

  S 	./xpm/barrel.xpm	

  C 43, 88, 72 
  F 77, 60, 46

 11111 111 111111111111111111
10000010001100000000000000001
10110000011100000020000010001
10011000000000000000000010001
10110000011100000000000002001
10000000001100000111011000001
 111011111  11011100000000001
 1110111111111011101010000001
12E00000110101011100000000001
10000000002000001100000010001
10000000000000001101010010001
11000000110101011111011112001
  110111  1101011111011110001
11  1       1 111111111111111
