	R 		2000		 1000

	
 	NO	   ./xpm/brick1.xpm   
 	SO	   ./xpm/brick2.xpm   
 	WE	   ./xpm/brick3.xpm   
 	EA	   ./xpm/brick4.xpm 
	S ./xpm/pillar.xpm		



		C 	9,	82,   77  
F 77,60,46

11111111111111111111111111111
10000000001100000000000000001
10110000011100000020000010001
10011000000000000000000010001
10110000011100000000000002001
10000000001100000111011000001
11110111111111011100000000001
11110111111111011101010000001
11000000110101011100000000001
10E22000002000001100000010001
10022000000000001101010010001
11000000110101011111011112001
11110111111101011111011110001
11111111111111111111111111111
