
	R 	800	 600


	
 	NO	   ./xpm/brick1.xpm   
 	SO	   ./xpm/brick2.xpm   
 	WE	   ./xpm/brick3.xpm   
 	EA	   ./xpm/brick4.xpm 
	S 	./xpm/barrel.xpm		



	C 43, 88, 72 
	F 77, 60, 46
   1  1    111   
 11111011110001  
0112100000000021 
210S0000000000021
01000002222222211
00100000000000010
000111111101101  
 12       1001002
