00000100000
00001010000
00010001000
00100000100
01000000010
001N0000100
00010001000
00001010000
00000100000
