1111111
 100001  1
100001  1
120000	1	
1000W01
1000001
1111111
