R 300 200
NO ./xpm/bluestone.xpm
SO ./xpm/purplestone.xpm
WE ./xpm/wood.xpm
EA ./xpm/redbrick.xpm
S ./xpm/pillar.xpm
C 76, 52, 43
F 34, 65, 45
111111
100101
102001
1100N1
111111
