R 800 800

1 1 1 1 1 1 1 1 1
1 0 0 1 1 0 0 2 1
1 0 0 0 2 0 0 0 1
1 1 1 0 0 0 0 0 1
1 0 2 0 0 1 1 0 1
1 0 0 0 0 0 0 0 1
1 1 0 N 0 0 0 2 1
1 1 1 1 1 1 1 1 1
