  NO ./xpm/brick4.xpm
  SO ./xpm/brick3.xpm
  WE ./xpm/brick2.xpm
 EA ./xpm/brick1.xpm
    R     600     600
   S    ./xpm/barrel.xpm
C 32, 60, 43
F 67, 54, 86

11111111110001
10110100011110
10000000000011
01S02000000011
01000011100010
01211110000100
00110001111000
20100010000000
00001110100000
01110001010000
00010000001000
10101111110000
