  NO ./xpm/bluestone.xpm
  SO ./xpm/purplestone.xpm
  WE ./xpm/wood.xpm
 EA ./xpm/redbrick.xpm
    R     600     300
   S    ./xpm/tonneau.xpm
C 255, 100, 10
F 255, 0, 255
11111111110001
10110100011110
10000000000011
0100N002000011
01000011100010
01011110000100
00110001111000
00100010000000
00001110100000
01110001010000
00010000001000
10101111110000
