00000100000
0E001010000
00010001000
00100000100
01000000010
00100000100
00010001000
00001010000
00000100000
